########################
# 1 #   # #  #2  #3  N #
# ##### # ### #  #######
# #     # # 1#   #  #  #
# # ## # ### ## ### ## #
#  #  #   #  #4     #  #
#### ## #### #### ## ###
#  N#  #5  #   #  #  # #
# ### # ## # # ### ## ##
# 2#   #4    #  3#5    E
########################
